BFS: 
+ +-+-+-+-+-+-+-+-+-+-+-+-+-+-+-+-+-+-+-+
|0|3 4 5|0 2|6 4 1 5|0|5|0 2 1|1 6 2|4 4|
+ + + + + +-+-+-+ + + + +-+ +-+-+ +-+-+ +
|1 2|6|7 9|3 7|2 7|7 8|8|9|7 3 7 1|8 4 8|
+-+-+ +-+ + + +-+ + +-+ + + +-+-+ + + + +
|8 4|8|3 1|9|2|8 3|9 1|0 2 3 3 1|6 2|9|5|
+-+ +-+-+ + +-+ +-+-+ +-+-+-+-+-+ + +-+ +
|4|0|8 5 4 6 0 4 9|4|2 3 4|0 8 1 3|9|2 5|
+ + + +-+ +-+-+-+-+ +-+ +-+-+ +-+-+ +-+-+
|7|5 2 6|7 1|7 4 8|9 6 5 7 0 5|3 6|5|9 3|
+ +-+-+ +-+-+-+ +-+-+-+ + +-+-+ +-+-+ +-+
|8|6 7|1 5 9|3|2 9 7 2 8|1 6|5|9|4 7|0 3|
+ +-+ + + +-+ + +-+-+-+ +-+-+ + + +-+-+ +
|7 9|0|6|0 3|9 5 0 5|2|3|3 2 8|6 0 5 8 0|
+ +-+ +-+-+-+ +-+-+-+ +-+ +-+ + +-+ +-+-+
|8 1 6|9|6|0 4|2 6|3|1 3|2|3 6|4|1|9|3 1|
+-+ + + + + +-+-+ + +-+ + +-+ + + + + +-+
|8 9|0 3|0 6 1 8 7 7 4 8 4|5|4 8|4 1 5| |
+-+ +-+ + +-+ +-+-+-+ +-+-+ +-+ + +-+-+ +
|0 9|4 6 7|2|9 8|3 5 9 6 4 5|7 5|2|3 0 4|
+-+-+ + +-+ +-+-+ +-+-+ + +-+-+ + +-+ + +
|0|7 1|5|6 9|9 3 4|8|7 5|6|6 1 8|0|1 5| |
+ + +-+-+ +-+ +-+ + +-+-+ +-+-+-+ +-+ +-+
|0 2|7|7 9 5 7|0 4|9|9 1 6 2 1|6|4 8|9|6|
+ +-+ + +-+ +-+ +-+ +-+ + +-+-+ +-+-+ + +
|1|8 3 0 4|0 8|8 6|5 0|0|3|5 9 4 7|9|6 0|
+ + + +-+-+ +-+-+-+ +-+-+ + +-+-+ + + +-+
|1|0|9|1|1 9|2 2|6 5|3|0|2|2 6|1 7 2 0|7|
+-+-+-+ +-+ +-+ +-+ + + + + +-+-+ +-+ + +
| |3 9|0 5 2 6 1 3|2|1 1 7 2 3|1 3 2|7 1|
+ + + +-+-+-+-+ + + + +-+ +-+ +-+ +-+ + +
| |6|5 2 5 7 4 4|3|7 4|2|3 4|7 0|3 8|2|8|
+ +-+ +-+-+ + +-+ + + + + +-+ +-+-+ + +-+
|7 4 0| |3 6|8|7|6|3|8|8 5|8|1|7|0 3|9|3|
+ + + + +-+-+ + + +-+-+-+-+ + + + +-+-+ +
| |8|5|0 6|4 7 5|4|9 4 4 9 8 5|7|2 5|6 1|
+ +-+ + + + +-+ +-+ +-+-+-+ + + +-+-+ + +
|   |9| |1 6|3 8 4|4|0 5 5 0|9 1 8 8 2|4|
+-+ + + + + +-+-+ +-+-+ +-+ + + +-+-+ + +
|   | | |7|2 8|1 9 2|5 1|6 6|2|9|5 2 7|6|
+-+-+-+-+-+-+-+-+-+-+-+-+-+-+-+-+-+-+-+ +

+ +-+-+-+-+-+-+-+-+-+-+-+-+-+-+-+-+-+-+-+
|#|#####|   |    ###| | |     |     |   |
+#+#+ +#+ +-+-+-+#+#+ + +-+ +-+-+ +-+-+ +
|###| |###|   |  #|#  | | |       |     |
+-+-+ +-+#+ + +-+#+#+-+ + + +-+-+ + + + +
|   | |  #| | |###|###|         |   | | |
+-+ +-+-+#+ +-+#+-+-+#+-+-+-+-+-+ + +-+ +
| | |    #######  | |###  |       | |   |
+ + + +-+ +-+-+-+-+ +-+#+-+-+ +-+-+ +-+-+
| |     |   |     |    #      |   | |   |
+ +-+-+ +-+-+-+ +-+-+-+#+ +-+-+ +-+-+ +-+
| |   |     | |#########|   | | |   |   |
+ +-+ + + +-+ +#+-+-+-+ +-+-+ + + +-+-+ +
|   | | |   |###    | | |     |         |
+ +-+ +-+-+-+#+-+-+-+ +-+ +-+ + +-+ +-+-+
|     | | |###|   | |   | |   | | | |   |
+-+ + + + +#+-+-+ + +-+ + +-+ + + + + +-+
|   |   |  ###########    | |   |     | |
+-+ +-+ + +-+ +-+-+-+#+-+-+ +-+ + +-+-+ +
|   |     | |   |    #####  |   | |     |
+-+-+ + +-+ +-+-+ +-+-+ +#+-+-+ + +-+ + +
| |   | |   |     | |   |#|     | |   | |
+ + +-+-+ +-+ +-+ + +-+-+#+-+-+-+ +-+ +-+
|   | |       |   | |    #    | |   | | |
+ +-+ + +-+ +-+ +-+ +-+ +#+-+-+ +-+-+ + +
| |       |   |   |   | |#|       | |   |
+ + + +-+-+ +-+-+-+ +-+-+#+ +-+-+ + + +-+
| | | | |   |   |   | | |#|   |       | |
+-+-+-+ +-+ +-+ +-+ + + +#+ +-+-+ +-+ + +
| |   |           | |    #####|     |   |
+ + + +-+-+-+-+ + + + +-+ +-+#+-+ +-+ + +
| | |           | |   | |   |#  |   | | |
+ +-+ +-+-+ + +-+ + + + + +-+#+-+-+ + +-+
|     | |   | | | | | |   | |#| |   | | |
+ + + + +-+-+ + + +-+-+-+-+ +#+ + +-+-+ +
| | | |   |     | |          #| |   |###|
+ +-+ + + + +-+ +-+ +-+-+-+ +#+ +-+-+#+#+
|   | | |   |     | |       |#########|#|
+-+ + + + + +-+-+ +-+-+ +-+ + + +-+-+ +#+
|   | | | |   |     |   |   | | |     |#|
+-+-+-+-+-+-+-+-+-+-+-+-+-+-+-+-+-+-+-+ +

Path: (0,0) (1,0) (1,1) (0,1) (0,2) (0,3) (1,3) (1,4) (2,4) (3,4) (3,5) (3,6) (3,7) (2,7) (2,8) (1,8) (0,8) (0,9) (1,9) (2,9) (2,10) (3,10) (3,11) (4,11) (5,11) (5,10) (5,9) (5,8) (5,7) (6,7) (6,6) (7,6) (7,5) (8,5) (8,6) (8,7) (8,8) (8,9) (8,10) (9,10) (9,11) (9,12) (10,12) (11,12) (12,12) (13,12) (14,12) (14,13) (14,14) (15,14) (16,14) (17,14) (18,14) (18,15) (18,16) (18,17) (18,18) (17,18) (17,19) (18,19) (19,19) 
Length of path: 61
Visited cells: 387

DFS: 
+ +-+-+-+-+-+-+-+-+-+-+-+-+-+-+-+-+-+-+-+
|0|3 4 7|   |    2 3| | |     |     |   |
+ + + + + +-+-+-+ + + + +-+ +-+-+ +-+-+ +
|1 2|5|8 9|   |1 0|4  | | |       |     |
+-+-+ +-+ + + +-+ + +-+ + + +-+-+ + + + +
|   |6|  0| | |8 9|5 6|         |   | | |
+-+ +-+-+ + +-+ +-+-+ +-+-+-+-+-+ + +-+ +
| | |    1 4 5 6 7| |7 8  |       | |   |
+ + + +-+ +-+-+-+-+ +-+ +-+-+ +-+-+ +-+-+
| |     |2 3|     |    9      |   | |   |
+ +-+-+ +-+-+-+ +-+-+-+ + +-+-+ +-+-+ +-+
| |   |     | |5 4 3 2 0|   | | |   |   |
+ +-+ + + +-+ + +-+-+-+ +-+-+ + + +-+-+ +
|   | | |   |9 6 7 8| |1|     |         |
+ +-+ +-+-+-+ +-+-+-+ +-+ +-+ + +-+ +-+-+
|     | | |1 0|   | |   | |   | | | |   |
+-+ + + + + +-+-+ + +-+ + +-+ + + + + +-+
|   |   |  2 3 6 7 8 9    | |   |     | |
+-+ +-+ + +-+ +-+-+-+ +-+-+ +-+ + +-+-+ +
|   |     | |4 5|    0 1 4  |   | |     |
+-+-+ + +-+ +-+-+ +-+-+ + +-+-+ + +-+ + +
| |   | |   |     | |3 2|5|     | |   | |
+ + +-+-+ +-+ +-+ + +-+-+ +-+-+-+ +-+ +-+
|   | |       |   | |    6    | |   | | |
+ +-+ + +-+ +-+ +-+ +-+ + +-+-+ +-+-+ + +
| |       |   |   |   | |7|       | |   |
+ + + +-+-+ +-+-+-+ +-+-+ + +-+-+ + + +-+
| | | | |   |   |   | | |8|   |       | |
+-+-+-+ +-+ +-+ +-+ + + + + +-+-+ +-+ + +
| |   |           | |    9 5 6|     |   |
+ + + +-+-+-+-+ + + + +-+ +-+ +-+ +-+ + +
| | |           | |   |3|0 4|7  |   | | |
+ +-+ +-+-+ + +-+ + + + + +-+ +-+-+ + +-+
|     | |   | | | | | |2 1| |8| |   | | |
+ + + + +-+-+ + + +-+-+-+-+ + + + +-+-+ +
| | | |   |     | |          9| |   |0 1|
+ +-+ + + + +-+ +-+ +-+-+-+ + + +-+-+ + +
|   | | |   |     | |       |0 2 4 5 6|2|
+-+ + + + + +-+-+ +-+-+ +-+ + + +-+-+ + +
|   | | | |   |     |   |   |1|3|9 8 7|3|
+-+-+-+-+-+-+-+-+-+-+-+-+-+-+-+-+-+-+-+ +

+ +-+-+-+-+-+-+-+-+-+-+-+-+-+-+-+-+-+-+-+
|#|#####|   |    ###| | |     |     |   |
+#+#+ +#+ +-+-+-+#+#+ + +-+ +-+-+ +-+-+ +
|###| |###|   |  #|#  | | |       |     |
+-+-+ +-+#+ + +-+#+#+-+ + + +-+-+ + + + +
|   | |  #| | |###|###|         |   | | |
+-+ +-+-+#+ +-+#+-+-+#+-+-+-+-+-+ + +-+ +
| | |    #######  | |###  |       | |   |
+ + + +-+ +-+-+-+-+ +-+#+-+-+ +-+-+ +-+-+
| |     |   |     |    #      |   | |   |
+ +-+-+ +-+-+-+ +-+-+-+#+ +-+-+ +-+-+ +-+
| |   |     | |#########|   | | |   |   |
+ +-+ + + +-+ +#+-+-+-+ +-+-+ + + +-+-+ +
|   | | |   |###    | | |     |         |
+ +-+ +-+-+-+#+-+-+-+ +-+ +-+ + +-+ +-+-+
|     | | |###|   | |   | |   | | | |   |
+-+ + + + +#+-+-+ + +-+ + +-+ + + + + +-+
|   |   |  ###########    | |   |     | |
+-+ +-+ + +-+ +-+-+-+#+-+-+ +-+ + +-+-+ +
|   |     | |   |    #####  |   | |     |
+-+-+ + +-+ +-+-+ +-+-+ +#+-+-+ + +-+ + +
| |   | |   |     | |   |#|     | |   | |
+ + +-+-+ +-+ +-+ + +-+-+#+-+-+-+ +-+ +-+
|   | |       |   | |    #    | |   | | |
+ +-+ + +-+ +-+ +-+ +-+ +#+-+-+ +-+-+ + +
| |       |   |   |   | |#|       | |   |
+ + + +-+-+ +-+-+-+ +-+-+#+ +-+-+ + + +-+
| | | | |   |   |   | | |#|   |       | |
+-+-+-+ +-+ +-+ +-+ + + +#+ +-+-+ +-+ + +
| |   |           | |    #####|     |   |
+ + + +-+-+-+-+ + + + +-+ +-+#+-+ +-+ + +
| | |           | |   | |   |#  |   | | |
+ +-+ +-+-+ + +-+ + + + + +-+#+-+-+ + +-+
|     | |   | | | | | |   | |#| |   | | |
+ + + + +-+-+ + + +-+-+-+-+ +#+ + +-+-+ +
| | | |   |     | |          #| |   |###|
+ +-+ + + + +-+ +-+ +-+-+-+ +#+ +-+-+#+#+
|   | | |   |     | |       |#########|#|
+-+ + + + + +-+-+ +-+-+ +-+ + + +-+-+ +#+
|   | | | |   |     |   |   | | |     |#|
+-+-+-+-+-+-+-+-+-+-+-+-+-+-+-+-+-+-+-+ +

Path: (0,0) (1,0) (1,1) (0,1) (0,2) (0,3) (1,3) (1,4) (2,4) (3,4) (3,5) (3,6) (3,7) (2,7) (2,8) (1,8) (0,8) (0,9) (1,9) (2,9) (2,10) (3,10) (3,11) (4,11) (5,11) (5,10) (5,9) (5,8) (5,7) (6,7) (6,6) (7,6) (7,5) (8,5) (8,6) (8,7) (8,8) (8,9) (8,10) (9,10) (9,11) (9,12) (10,12) (11,12) (12,12) (13,12) (14,12) (14,13) (14,14) (15,14) (16,14) (17,14) (18,14) (18,15) (18,16) (18,17) (18,18) (17,18) (17,19) (18,19) (19,19) 
Length of path: 61
Visited cells: 84
